11111111111111111111
1E0000000000000000C1
10000000000000000001
10000000000000000001
10000000000000000001
10000000010000000001
100000001P1000000001
10000000010000000001
10000000000000000001
10000000000000000001
10000000000000000001
11111111111111111111
