11111111111111111111111111
10000000000000000000000001
10000000000000000000000001
10000011111111111111000001
10000010000000000001000001
10000010111101111101000001
100000101C00E000C101000001
10000010111111111101000001
10000010000000000001000001
10000011111101111111000001
10000000000000000000000001
10000000000000000000000001
10000000000000000000000001
10000000000000000000000001
100000000000P0000000000001
10000000000000000000000001
11111111111111111111111111
