1111111111111111111111111111111111111111
1C0000000000000000C0000000000000000000C1
1011111111111111111111111111111111111101
1000010000000000000C00000000000000000001
1000010001111111111111111111110000100001
100001000000000000C000000000000000100001
1000010001111111111111111111110000100001
1000010000000000000000000000000000100001
1000000000101111111111111001000000100001
10000000001C00000000000000010000000000C1
10C000000010000000E000000001000000000001
1000000000101111111111111001000000000001
1000100000000000000000000000000000100001
1000100000000000000000000000000000100001
1000100000000000000000000000000000100001
1000111111000000C00000111111111111000001
100000000000000000000000C000000000000001
1011111111111111111111111111111111111101
1C000000000000000P00000000000000000000C1
1111111111111111111111111111111111111111
