11111111111111111111111111111111111111
11100000000000000000000000000000000111
11100000000000000000000000000000000011
1100000000000000000000000000000C000011
1000000000E000000000000000000000000001
10000000111000000000000001110000000001
10000000111000000000000001110000000001
10000000000000000000000000000000000001
10000000000000000110000000000000000001
10000000000000001111000000000000000001
10000000000000011111100000000000000001
10000000000000000000000000000000000001
100000100000000000000000001000000C0001
1000000100000C000000000001000000000001
10000000100000000000000010000000000001
10000000000111111111111000000000000001
11000000000000000000000000000000000011
11000000000000000000000000000000000111
11100000000000000000000000000P00001111
11111111111111111111111111111111111111
